
shortcuts de cinema 4d

interface:

	view perepective: F1

	view Top: F2

	view Right: F3

	view From: F4

	4 views; F5

	maximixed view: Control+Tab

	centrar viewport: Alt2+O / H

	freme selection: S

	HyperNurbs: Q


	menú de visualización: N+

		shading simple: N+A

		shading lines: N+B
		
		shading rápido: N+C

		shading lines rápido: N+D

		shading contrast ó volumen: N+E

		shading volumen con líneas: N+F

		wareframe: N+G

		shading HyperNurbs: N+H

		shading Isoparms: N+I

		backface culling: N+P

		shading Textures: N+Q

		XRay: N+R

	


herramientas

	extrude inner: I
	
	extrude: D

	bridge: B

	knife: K
	
	menú de herramientas: m+	

		Smooth Tool: M+Y

		Magnet: M+I

	


paneles

	

	

	menú de

	menú Snaps: p

	menú edición: V







